NO ./textures/wall_north.png
SO ./textures/wall_south.png
WE ./textures/wall_west.png
EA ./textures/wall_east.png
F 220,100,0
C 225,30,0

11111111
10100001111111
10100000000001
10100000000001
100000011C1101
100S0101000101
10000001000101
11111111111111
