NO ./path_to_the_north_texture
SO ./path_to_the_south_texture
WE ./path_to_the_west_texture
EA ./path_to_the_east_texture
F 220,100,0
C 225,30,0


F6

C
  111111
11100011
10100001
10100001
10100001
10000001
EA
10000101
10000001
11111111