NO ./textures/wall_north.png
SO ./textures/wall_south.png
WE ./textures/wall_west.png
EA ./textures/wall_east.png
F 220,100,0
C 225,30,0

11111111
10100001111111
10100000000001
10100000000001
10000001111101
100S0101   101
10000001   101
11111111   111