NO ./textures/bonus/wall_north.png
SO ./textures/bonus/wall_south.png
WE ./textures/bonus/wall_west.png
EA ./textures/bonus/wall_east.png

F 220,100,0
C 25,125,25

        1111111111111111111111111
        1000000000110000000000H01
        1011000001110000000W00001
        10010000000C000X0011000A1
111111111011000001110000000000001
10000000001100000111C111111111111
11110111111111011100000010001
11110111111111011101010010001
11000000110101011100000010001
1000000000000000CC00000010001
10000000000000001101010010001
11000001110101011111011110001
11110111 1110101 101111010001
11111111 1111111 111111111111
