NO ./textures/bonus/wall_north.png
SO ./textures/bonus/wall_south.png
WE ./textures/bonus/wall_west.png
EA ./textures/bonus/wall_east.png

F 220,100,0
C 25,125,25

        1111111111111111111111111
        100000000011000H000000H01
        1011000001110000000W00001
        10010000000C000X0011000A1
111111111011000001110000000000001
10000000001100000111C111100111111
11110111111111011100000010001
11110111111111011101010010001111111111
11000000110101011100000010A00000000001
1000000000000000CC00000010000000000001
100000000000000011010100100000H0000001
11000001110101011111011110001111111111
11110111 1110101 101000000001
11111111 1111111 111111111111
